1 2 9 1 0 
9 2 1 1 0 
1 1 0 0 0 
2 3 3 3 2 
9 9 9 9 9 
