10
- - - - * - - - - -
* * * * * * * * * *
- * - * * - - - - -
- * * * - - - * * *
- * - - - * * * - -
* * - - * - - - - *
* * * - - - - - - -
- - - - - - - - - -
* * * * * - - * * *
- - - * * * - * * -

