2 3 3 4 9 4 3 3 3 2 
9 9 9 9 9 9 9 9 9 9 
4 9 8 9 9 4 4 5 6 4 
3 9 9 9 4 3 4 9 9 9 
4 9 5 3 3 9 9 9 5 3 
9 9 4 2 9 3 3 2 2 9 
9 9 9 2 1 1 0 0 1 1 
4 6 5 4 2 1 1 2 3 2 
9 9 9 9 9 3 3 9 9 9 
2 3 4 9 9 9 3 9 9 3 
