XXXOOOOOO
OXXXOOOOO
OOXXXOOOO
OOOXXXOOO
OXOXOXOXO
XOXOXOXOX
OOOOOOOOO
