OXXXOOOOO
OOXXXOOOO
OXXXOOOOO
XXXXXXOOO
OXOXOXOXO
XOXOXOXOX
OOOOOOOOO

